1111111111111111
1              1
1111111111112 21
11 2222222222 21
13333332 2222  1
1          22 22
1              2
1 333332  222  2
1 22222222222222
1              1
11111111111111 1
1              1
1              1
1              1
1              1
1111111111111111