55565555555565555555555555555444
8                              4
555655 5555   5555 5555555555444
1     7   5   5   7            1
1         5   5                1
1         5   5                1
1         5   5                1
1                              1
1                              1
1                              1
1                              1
1                              1
1                              1
1                              1
1                              1
1                              1
1                              1
1                              1
1                              1
1                              1
1                              1
1                              1
1                              1
1                              1
1                              1
1                              1
1                              1
1                              1
1                              1
1                              1
1                              1
11111111111111111111111111111111