1111111111111111
1000000000000001
1111111111112021
1102222222222021
1333333202222001
1000000000022022
1000000000000002
1033333200222002
1022222222222222
1000000000000001
1111111111111101
1000000000000001
1000000000000001
1000000000000001
1000000000000001
1111111111111111